thumbnail=
modal=anejartito
toggle=?
dropped file=? metafermeno (drag and drop) (afimeno?)
handler = xeiristis
template = odigos
pipe = swlinwsi
tile = epistrvsi (tile icons)
cascade = κατάχυση (καταχύνομαι)
arrange = taktopoihsh
username = xrhsths
password = kvdikos

drag and drop = syrsimo kai ripsi (afimeno)
popup = anarthsh

embeded = emfytevmeno
scaling = klimakvsi

clipboard = temaxio
lookup = anazhthsh (anatrejimo/anatrexw)

preferences = protimiseis
settings = ry8miseis
options = epilogew
properties = idiotites

tab = kartela
notebook = tetradio
interface = diepifaneia, diasyndesh
locate = entopismos

about... = sxetika me...
view = apeikonisi / opsi

document = arxeio i documento?
file = arxeio

grab = jesikwma

-> bonobo
storage = apo8iki
stream = roi
menu = menou
toolbar = mpara ergaleivn (ergalio8iki)
moniker = aploustebmeno onoma
paint = zografiki
component = systatiko
view = proboli
instance =?   (programm instance)


=========BONOBO WAITS
SAWFISH = PRIONOPSARO (yparxei)
edge flipping = ka8eptrismos akris/anadiplvsi akris/tinagma akris (3)
Shadow hover = skiasi metevrisma
Window cycling = metafora metaji para8irvn
focus = prosoxi (omws, "estiasmeno", "epikentromeno"???)
bindings = syndeseis
flip = antilaktisma (to klwtsima sta pyrobola opla) (flipping between screens)
bevel = lojotmish.
warping = ektinaji (metafora metaji xvrwn ergasias)
tooltips = boithimata
viewport = opsi
insert = eisagvgh i parembolh?
edit = epejergasia i diorthosi?
snap = proskolisi (window edges to desktop)
shade -v = skiash
unshare -v = aposkiash
raise = anasikosi
default = ej orismoy i ej' orismoy???
slide -v : olis8ima
transient = braxybiwn
cycling = diadoxi parauyrvn.
gradient=? antavgeia hehe
highlighted = fotismeno
about...=peri...

spooler=


